F F F F F F F F F F F F F F F F F F F F F F F F F F F F F F F F F F F F F F F F F F F F
O O F F F F O F F F F F F F F F F O F F F F F F F F O O O F F F O F F F O O O F F F F F
F O F F F F O O O F F F F F F O O O F O O O F F F F O F O F F O O O F F O F F F O O O F
F O F F O O O F O F F F F O O O F O F O F O F O F F O F O F F F O F F F O F F F O F O F
F O F F O F O F O O O F O O F F F O O O F O F O O O O O O O F F O F F F O O O F O O O F
F O O O O F O F F F O F O F F F F F F F F O F F F O F O F O O O O O O F F F O O O F F F
F F F F O O O F F F O O O F F F F O O O F O F F F O F O F O F F F F O F F F O F F F F F
F F F F O F F F F F F F F F F F F O F O F O F F F O F F F O F F F F O F F F O F F F F F
F F F F O F F F F F F F F F F F F O F O F F F F F O F F F O F F F F F F F F O F F F F F
F O O O O O O F F F F F F F F F F O F F F F F F F O F F F O F F F F F F F O O O O O F F
F F F F O F O F F F O O O O O O O O O O F F F F F O F F F O O F F F F F F O F F F O O O
F F F F O F O F F F O F F F F F O F F O F F F F F O F F F F O F F F F F F O F F F F F F
F F F F O F F F F F O F F F F F O F F O O O F F F O F F F F O O O O O O O O O F F F F F
F F F F O F F O O O O O O O O O O F F F F O F F F O F F F F F F F O F F F F O F F F F F
F O O O O F F O F O F F O F F F O F F F F O F F F O O O O F O F F O F F F F O F F F F F
F O F F O F F O F O F F O F F F O F F F F O O O O O F F O F O O F O O O O F O F F F F F
F O O O O F F O O O F F O F F F O F F F F F F O F F F F O F F O F O F F O F O O O O F F
F F F F O F F F O O F F O F F F O F F F F F F O F F F F O O F O O O F F O F O F F F F F
F F F F O O O O O F F F O O F F O O O O O O O O F F F F F O F F F F F O O O O F F F F F
F F F F F F F F F F F F F F F F F F F F F F F F F F F F F F F F F F F F F F F F F F F F
